24
20
1
10
0
0
0,0,0,0,0,0,0,0,0,0,0,0,0,0,0,0,0,0,0,0,0,0,0,0,
0,0,0,0,0,0,0,0,0,0,0,0,0,0,0,0,0,0,0,0,0,0,0,0,
2,2,3,0,0,0,0,0,0,0,0,0,0,0,0,0,1,2,2,2,2,2,2,2,
18,18,20,2,3,0,0,0,0,0,0,0,0,0,1,2,21,18,4,34,34,34,34,34,
18,18,81,82,20,2,2,2,2,2,2,2,2,2,21,81,82,18,19,36,36,36,36,36,
81,82,18,18,81,82,18,18,81,82,18,18,81,82,18,18,18,18,19,36,36,36,36,36,
18,18,18,18,18,18,81,82,18,18,81,82,18,18,81,82,81,82,19,36,36,1,2,2,
81,82,25,9,81,82,25,9,81,82,18,18,81,82,18,18,18,18,19,36,36,17,18,18,
34,34,34,34,34,34,34,34,5,18,81,82,18,18,81,82,81,82,19,36,36,17,81,82,
36,36,36,36,36,36,36,36,17,81,82,18,81,82,18,81,82,18,19,36,36,17,18,18,
36,36,36,36,36,36,36,36,17,18,18,18,18,18,18,18,18,18,19,36,36,17,81,82,
2,2,2,2,2,3,36,36,17,18,18,18,18,18,18,18,18,18,19,36,36,17,18,18,
18,18,18,18,18,19,36,36,17,18,18,18,18,18,18,18,18,18,19,36,36,17,81,82,
81,82,18,18,18,19,36,36,17,18,18,18,18,18,18,18,18,18,19,36,36,17,18,18,
18,18,81,82,18,19,36,36,17,18,18,18,18,18,18,18,18,18,19,36,36,17,81,82,
81,82,18,18,18,19,36,36,33,34,34,34,34,34,34,34,34,34,35,36,36,17,18,18,
18,18,81,82,18,19,36,36,36,36,36,36,36,36,36,36,36,36,36,36,36,17,81,82,
81,82,18,18,18,19,36,36,36,36,36,36,36,36,36,36,36,36,36,36,36,17,18,18,
18,18,81,82,18,20,2,2,2,2,2,2,2,2,2,2,2,2,2,2,2,21,81,82,
81,82,18,18,81,82,18,18,81,82,18,18,81,82,18,18,81,82,18,18,81,82,18,18
192,192,192,192,192,192,192,192,192,192,192,192,192,192,192,192,192,192,192,192,192,192,192,192,
192,192,192,192,192,192,192,192,192,192,192,192,192,192,192,192,192,192,192,192,192,192,192,192,
0,0,0,192,192,192,192,192,192,192,192,192,192,192,192,192,0,0,0,0,0,0,0,0,
0,0,65,66,0,192,192,192,192,192,192,192,192,192,0,65,66,0,0,0,0,0,0,0,
65,66,0,0,65,66,0,0,65,66,0,0,65,66,0,0,0,0,0,144,144,144,95,0,
0,0,65,66,0,0,65,66,0,0,65,66,0,0,65,66,65,66,0,128,144,144,95,0,
65,66,0,0,65,66,0,0,65,66,0,0,65,66,0,0,0,0,0,128,128,0,0,0,
0,0,0,0,0,0,0,0,0,0,65,66,0,0,65,66,65,66,0,128,128,0,65,66,
0,0,0,0,0,0,0,0,0,65,66,0,65,66,0,65,66,0,e3,128,128,e3,0,0,
0,0,0,0,0,0,0,0,0,100,101,101,101,101,101,101,101,102,128,0,0,128,65,66,
0,0,0,0,0,0,0,0,0,116,0,0,0,43,0,0,0,118,128,0,0,128,0,0,
0,0,0,0,0,0,0,0,0,e2,144,144,144,144,e2,176,176,118,128,63,63,128,65,66,
65,66,0,0,0,0,0,0,0,e2,160,160,160,160,e2,176,176,118,128,0,0,128,0,0,
0,0,65,66,0,0,0,0,0,116,0,0,0,43,0,0,0,118,0,0,0,0,65,66,
65,66,0,0,0,0,0,0,0,132,101,101,101,101,101,101,101,134,0,0,0,0,0,0,
0,0,65,66,0,0,0,0,0,0,0,112,0,0,0,112,0,0,0,0,0,0,65,66,
65,66,0,0,0,0,0,0,0,0,0,e2,0,0,0,e2,0,0,0,0,0,0,0,0,
0,0,65,66,0,0,0,0,0,0,0,128,0,0,0,128,0,0,0,0,0,0,65,66,
65,66,0,0,65,66,0,0,65,66,0,0,65,66,0,0,65,66,0,0,65,66,0,0,
0,0,65,66,0,0,65,66,0,0,65,66,0,0,65,66,0,0,65,66,0,0,65,66
1
0,0,0,0,0,0,0,0,0,0,0,0,0,0,0,0,0,0,0,0,0,0,0,0,
0,0,0,0,0,0,0,0,0,0,0,0,0,0,0,0,0,0,0,0,0,0,0,0,
0,0,49,50,0,0,0,0,0,0,0,0,0,0,0,49,50,0,0,0,0,0,0,0,
49,50,0,0,49,50,0,0,49,50,0,0,49,50,0,0,0,0,0,0,0,0,0,0,
0,0,49,50,0,0,49,50,0,0,49,50,0,0,49,50,49,50,0,0,0,0,0,0,
49,50,0,0,49,50,0,0,49,50,0,0,49,50,0,0,0,0,0,0,0,0,0,0,
0,0,0,0,0,0,0,0,0,0,49,50,0,0,49,50,49,50,0,0,0,0,49,50,
0,0,0,0,0,0,0,0,0,49,50,0,49,50,0,49,50,0,0,0,0,0,0,0,
0,0,0,0,0,0,0,0,0,0,0,0,0,0,0,0,0,0,0,0,0,0,49,50,
0,0,0,0,0,0,0,0,0,0,0,0,0,0,0,0,0,0,0,0,0,0,0,0,
0,0,0,0,0,0,0,0,0,0,0,0,0,0,0,0,0,0,0,0,0,0,49,50,
49,50,0,0,0,0,0,0,0,0,0,0,0,0,0,0,0,0,0,0,0,0,0,0,
0,0,49,50,0,0,0,0,0,0,0,0,0,0,0,0,0,0,0,0,0,0,49,50,
49,50,0,0,0,0,0,0,0,0,0,0,0,0,0,0,0,0,0,0,0,0,0,0,
0,0,49,50,0,0,0,0,0,0,0,0,0,0,0,0,0,0,0,0,0,0,49,50,
49,50,0,0,0,0,0,0,0,0,0,0,0,0,0,0,0,0,0,0,0,0,0,0,
0,0,49,50,0,0,0,0,0,0,0,0,0,0,0,0,0,0,0,0,0,0,49,50,
49,50,0,0,49,50,0,0,49,50,0,0,49,50,0,0,49,50,0,0,49,50,0,0,
0,0,49,50,0,0,49,50,0,0,49,50,0,0,49,50,0,0,49,50,0,0,49,50,
0,0,0,0,0,0,0,0,0,0,0,0,0,0,0,0,0,0,0,0,0,0,0,0