24
20
11
1
1
0
61,61,61,61,61,83,84,61,61,61,61,61,61,83,84,61,61,61,61,61,61,61,61,61,
61,61,61,61,61,61,61,61,61,61,61,61,61,61,61,61,61,61,61,61,61,61,61,61,
83,84,61,61,61,61,61,61,61,61,61,61,61,61,61,61,61,61,61,61,61,61,61,83,
61,61,61,61,61,61,61,61,61,61,61,61,61,61,61,61,61,61,61,61,61,61,61,61,
61,61,61,61,61,61,61,61,61,83,84,61,61,61,61,61,61,61,61,61,61,61,61,61,
61,61,61,61,61,61,61,61,61,61,61,61,61,61,61,61,61,61,61,61,61,61,61,61,
61,61,61,83,84,61,61,61,61,61,61,61,61,61,61,61,61,61,61,61,61,61,61,61,
61,61,61,61,61,61,61,61,61,61,61,61,61,61,61,61,83,84,61,61,61,61,61,61,
61,61,61,61,61,61,61,61,61,61,61,61,61,61,61,61,61,61,61,61,61,61,61,61,
61,61,61,61,61,61,61,61,61,61,61,61,61,61,61,61,61,61,61,61,61,61,61,61,
61,83,84,61,61,61,61,61,61,61,61,61,61,61,61,61,61,61,61,61,61,61,61,83,
61,61,61,61,61,61,61,61,61,61,61,61,61,61,61,61,61,61,61,61,61,61,61,61,
61,61,61,61,61,61,61,61,83,84,61,61,61,61,61,61,61,61,61,61,61,61,61,61,
61,61,61,61,61,61,61,61,61,61,61,61,61,61,61,61,61,61,61,61,61,61,61,61,
61,61,61,61,61,61,61,61,61,61,61,61,61,61,61,61,61,61,61,83,84,61,61,61,
61,61,61,61,61,61,61,61,61,61,61,61,61,61,61,61,61,61,61,61,61,61,61,61,
61,61,61,61,61,61,61,61,61,61,74,77,77,75,61,61,61,61,61,61,61,61,61,61,
61,61,61,61,61,61,61,61,61,61,62,59,59,60,83,84,61,61,61,61,61,61,61,83,
61,61,61,61,61,61,61,61,61,61,62,59,59,60,61,61,61,61,61,83,84,61,61,61,
61,83,84,61,61,61,61,61,61,61,62,59,59,60,61,61,61,61,61,61,61,61,61,61
0,0,115,0,0,0,0,0,0,0,0,0,0,0,0,0,0,0,115,0,0,0,0,0,
67,68,115,87,0,0,0,0,71,0,0,0,0,0,0,0,0,176,115,71,0,0,95,67,
0,0,147,0,0,0,0,0,130,98,98,98,98,114,0,0,0,0,115,0,0,0,0,0,
0,0,176,0,0,0,0,e8,0,85,86,0,0,e8,0,0,0,92,147,0,0,93,148,0,
92,130,98,98,98,98,114,0,87,0,0,0,0,130,98,98,98,114,0,0,0,0,115,0,
146,0,0,85,86,0,0,0,0,0,0,0,0,0,146,0,0,0,0,0,87,0,115,0,
113,0,0,e8,144,e8,0,93,144,144,144,144,144,112,113,0,67,68,0,0,0,0,115,0,
113,0,0,0,128,92,0,0,0,0,0,87,0,112,113,0,0,0,0,0,0,0,147,0,
113,0,0,0,e8,148,0,0,0,0,0,0,0,112,113,0,0,0,0,0,0,0,71,0,
113,67,68,0,128,115,0,0,0,0,0,0,0,112,145,87,0,0,0,0,0,0,0,67,
113,71,0,0,128,115,0,130,98,98,98,114,0,144,e8,144,144,176,0,0,0,0,92,0,
113,176,e8,0,0,115,0,0,85,86,0,0,130,98,98,114,e8,0,0,0,71,0,0,0,
113,e8,93,0,0,147,0,0,0,0,0,0,0,93,0,0,e8,130,98,98,98,98,114,71,
113,0,0,0,0,e8,160,160,160,0,0,0,144,e8,112,0,128,160,160,67,68,0,0,0,
113,130,98,98,98,114,0,71,128,0,0,0,128,148,e8,144,144,112,e8,0,0,0,176,0,
113,0,0,0,0,0,0,63,80,160,160,160,128,115,0,0,87,112,128,0,0,0,176,0,
113,0,93,0,e8,160,160,160,160,0,0,128,80,115,85,86,0,63,128,0,0,0,146,85,
113,0,0,0,0,0,0,0,0,0,146,e8,e8,115,0,92,0,0,0,67,68,0,113,0,
145,67,68,71,130,98,98,98,114,0,113,0,0,115,0,0,0,0,0,0,93,0,113,0,
0,0,0,0,0,0,0,0,0,0,113,0,0,115,130,98,98,98,114,0,0,0,113,0
1
51,52,0,0,0,0,0,0,0,0,0,0,0,0,0,0,0,0,0,0,0,0,0,51,
0,0,0,0,0,0,0,0,0,0,0,0,0,0,0,0,0,0,0,0,0,0,0,0,
0,0,0,0,0,0,0,0,0,69,70,0,0,0,0,0,0,0,0,0,0,0,0,0,
0,0,0,0,0,0,0,0,0,0,0,0,0,0,0,0,0,0,0,0,0,0,0,0,
0,0,0,69,70,0,0,0,0,0,0,0,0,0,0,0,0,0,0,0,0,0,0,0,
0,0,0,0,0,0,0,0,0,0,0,0,0,0,0,0,51,52,0,0,0,0,0,0,
0,0,0,0,0,0,0,0,0,0,0,0,0,0,0,0,0,0,0,0,0,0,0,0,
0,0,0,0,0,0,0,0,0,0,0,0,0,0,0,0,0,0,0,0,0,0,0,0,
0,51,52,0,0,0,0,0,0,0,0,0,0,0,0,0,0,0,0,0,0,0,0,51,
0,0,0,0,0,0,0,0,0,0,0,0,0,0,0,0,0,0,0,0,0,0,0,0,
0,0,0,0,0,0,0,0,69,70,0,0,0,0,0,0,0,0,0,0,0,0,0,0,
0,0,0,0,0,0,0,0,0,0,0,0,0,0,0,0,0,0,0,0,0,0,0,0,
0,0,0,0,0,0,0,0,0,0,0,0,0,0,0,0,0,0,0,51,52,0,0,0,
0,0,0,0,0,0,0,0,0,0,0,0,0,0,0,0,0,0,0,0,0,0,0,0,
0,0,0,0,0,0,0,0,0,0,0,0,0,0,0,0,0,0,0,0,0,0,0,0,
0,0,0,0,0,0,0,0,0,0,0,0,0,0,69,70,0,0,0,0,0,0,0,69,
0,0,0,0,0,0,0,0,0,0,0,0,0,0,0,0,0,0,0,51,52,0,0,0,
0,51,52,0,0,0,0,0,0,0,0,0,0,0,0,0,0,0,0,0,0,0,0,0,
0,0,0,0,0,0,0,0,0,0,0,0,0,0,0,0,0,0,0,0,0,0,0,0,
0,0,0,0,0,0,0,0,0,0,0,0,0,0,0,0,0,0,0,0,0,0,0,0