26
22
9
1
1
0
61,61,61,61,61,61,61,61,61,61,61,61,61,61,62,59,59,60,61,61,61,61,61,61,61,61,
61,61,61,61,83,84,61,61,61,83,84,61,61,61,62,59,59,60,61,61,61,61,61,61,61,61,
61,61,61,61,61,61,61,61,61,61,61,61,61,61,62,59,59,60,83,84,61,61,61,61,83,84,
61,61,61,61,74,77,77,77,77,77,77,77,77,77,78,59,59,76,77,77,77,75,61,61,61,61,
61,61,61,61,62,59,59,59,59,59,59,59,59,59,59,59,59,59,59,59,59,60,61,61,61,61,
61,61,74,77,78,59,59,59,59,59,59,59,59,59,59,59,59,59,59,59,59,76,77,75,61,61,
61,61,62,59,59,59,59,44,45,45,45,45,45,45,45,45,45,45,46,59,59,59,59,60,61,61,
83,84,62,59,59,59,59,60,61,61,61,61,61,61,61,61,61,61,62,59,59,59,59,60,61,61,
61,61,62,59,59,44,45,91,61,61,61,61,61,61,61,61,61,61,90,45,46,59,59,60,61,61,
61,61,62,59,59,60,61,61,61,61,61,61,61,61,61,61,61,61,61,61,62,59,59,60,61,61,
61,61,62,59,59,60,61,61,61,61,61,61,61,61,61,61,61,61,61,61,62,59,59,60,61,61,
61,61,62,59,59,60,61,61,61,61,61,61,61,61,61,61,61,61,61,61,62,59,59,60,61,61,
61,61,62,59,59,60,61,61,61,61,61,61,61,61,61,61,61,61,61,61,62,59,59,60,61,61,
61,61,62,59,59,76,77,75,61,61,61,61,61,61,61,61,61,61,74,77,78,59,59,60,61,61,
83,84,62,59,59,59,59,60,61,61,61,61,61,61,61,61,61,61,62,59,59,59,59,60,61,61,
61,61,62,59,59,59,59,76,77,77,77,77,77,77,77,77,77,77,78,59,59,59,59,60,83,84,
61,61,90,45,46,59,59,59,59,59,59,59,59,59,59,59,59,59,59,59,59,44,45,91,61,61,
61,61,61,61,62,59,59,59,59,59,59,59,59,59,59,59,59,59,59,59,59,60,61,61,61,61,
61,61,61,61,90,45,45,45,46,59,59,44,45,45,45,45,45,45,45,45,45,91,61,61,61,61,
61,61,61,61,61,61,61,61,62,59,59,60,61,61,61,61,61,61,61,61,61,61,61,61,61,61,
61,61,61,61,61,61,61,61,62,59,59,60,61,61,61,61,61,61,61,61,61,61,61,61,83,84,
83,84,61,61,61,61,61,61,62,59,59,60,61,61,83,84,61,61,83,84,61,61,61,61,61,61
0,0,0,0,67,68,0,0,0,67,68,0,0,93,113,0,0,115,0,0,0,0,93,0,0,0,
0,93,0,0,0,0,0,0,87,0,e7,0,0,0,113,95,95,115,85,86,0,0,0,0,67,68,
0,0,0,0,0,0,0,93,0,e7,0,93,0,0,113,128,128,115,0,0,93,0,0,0,0,0,
87,0,0,92,0,0,0,e8,0,0,0,0,e8,0,145,128,128,147,0,0,e8,0,93,0,87,0,
0,0,93,0,0,144,144,80,144,144,144,144,80,144,144,128,128,160,160,160,80,e8,0,0,e7,0,
0,0,146,0,e8,128,144,144,144,144,80,144,144,80,144,128,80,160,160,160,128,0,e7,148,0,0,
67,68,113,144,80,128,80,e8,0,0,e8,0,e7,e8,e7,e7,e8,e7,e8,80,128,160,160,115,0,0,
0,0,113,128,144,144,128,0,92,93,0,0,0,0,87,0,0,0,0,128,160,160,128,115,93,0,
93,0,113,128,128,0,0,71,0,0,0,71,0,0,0,0,92,0,0,0,0,128,128,115,0,0,
0,0,113,128,128,0,0,0,93,0,87,0,71,71,0,93,0,0,71,0,0,128,128,115,0,0,
0,0,113,128,80,e8,92,93,0,92,0,93,176,0,0,87,176,71,0,93,e8,80,128,115,0,0,
0,0,113,128,128,0,0,0,71,0,0,176,71,92,71,0,92,0,92,0,0,128,128,115,0,93,
0,0,113,128,128,0,71,0,93,0,0,71,0,0,0,0,93,0,0,0,0,128,128,115,0,176,
85,86,113,128,80,e8,0,0,0,92,0,0,0,87,0,0,0,87,0,0,0,128,128,115,0,0,
0,0,113,128,128,160,160,0,0,0,0,71,0,0,0,0,0,0,0,144,144,128,128,115,85,86,
0,0,113,128,160,160,128,0,e8,0,0,0,0,e8,0,0,0,e8,0,128,144,144,128,115,0,0,
93,0,145,0,0,128,128,160,80,160,144,144,144,80,144,144,144,80,144,128,128,0,0,147,0,0,
0,0,0,0,0,128,80,160,160,80,80,144,144,144,144,80,144,144,144,144,128,0,0,93,0,0,
0,0,0,92,0,0,e8,0,0,128,128,0,0,0,0,e8,0,0,0,0,0,0,0,0,0,0,
0,0,93,0,0,0,0,0,0,128,128,0,93,0,0,0,87,0,0,0,0,92,0,0,67,68,
67,68,0,0,87,0,0,0,0,0,0,0,0,0,85,86,0,0,67,68,0,0,93,0,0,0,
0,0,0,0,0,0,93,0,0,0,0,0,0,0,0,0,0,0,0,0,0,0,0,0,0,0
1
0,0,0,0,0,0,0,0,0,0,0,0,0,0,0,0,0,0,69,70,0,0,0,0,51,52,
0,0,0,0,0,0,0,0,0,0,0,0,0,0,0,0,0,0,0,0,0,0,0,0,0,0,
0,0,0,0,0,0,0,0,0,0,0,0,0,0,0,0,0,0,0,0,0,0,0,0,0,0,
0,0,0,0,0,0,0,0,0,0,0,0,0,0,0,0,0,0,0,0,0,0,0,0,0,0,
0,0,0,0,0,0,0,0,0,0,0,0,0,0,0,0,0,0,0,0,0,0,0,0,0,0,
51,52,0,0,0,0,0,0,0,0,0,0,0,0,0,0,0,0,0,0,0,0,0,0,0,0,
0,0,0,0,0,0,0,0,0,0,0,0,0,0,0,0,0,0,0,0,0,0,0,0,0,0,
0,0,0,0,0,0,0,0,0,0,0,0,0,0,0,0,0,0,0,0,0,0,0,0,0,0,
0,0,0,0,0,0,0,0,0,0,0,0,0,0,0,0,0,0,0,0,0,0,0,0,0,0,
0,0,0,0,0,0,0,0,0,0,0,0,0,0,0,0,0,0,0,0,0,0,0,0,0,0,
0,0,0,0,0,0,0,0,0,0,0,0,0,0,0,0,0,0,0,0,0,0,0,0,0,0,
0,0,0,0,0,0,0,0,0,0,0,0,0,0,0,0,0,0,0,0,0,0,0,0,0,0,
69,70,0,0,0,0,0,0,0,0,0,0,0,0,0,0,0,0,0,0,0,0,0,0,0,0,
0,0,0,0,0,0,0,0,0,0,0,0,0,0,0,0,0,0,0,0,0,0,0,0,69,70,
0,0,0,0,0,0,0,0,0,0,0,0,0,0,0,0,0,0,0,0,0,0,0,0,0,0,
0,0,0,0,0,0,0,0,0,0,0,0,0,0,0,0,0,0,0,0,0,0,0,0,0,0,
0,0,0,0,0,0,0,0,0,0,0,0,0,0,0,0,0,0,0,0,0,0,0,0,0,0,
0,0,0,0,0,0,0,0,0,0,0,0,0,0,0,0,0,0,0,0,0,0,0,0,0,0,
0,0,0,0,0,0,0,0,0,0,0,0,0,0,0,0,0,0,0,0,0,0,0,0,51,52,
51,52,0,0,0,0,0,0,0,0,0,0,0,0,69,70,0,0,51,52,0,0,0,0,0,0,
0,0,0,0,0,0,0,0,0,0,0,0,0,0,0,0,0,0,0,0,0,0,0,0,0,0,
0,0,0,0,0,0,0,0,0,0,0,0,0,0,0,0,0,0,0,0,0,0,0,0,0,0